NO ./assets/textures/mur_1_128.xpm
SO ./assets/textures/mur_2_128.xpm
WE ./assets/textures/mur_3_128.xpm
EA ./assets/textures/mur_4_128.xpm

F 50,50,50
C 25,25,25

11111111111111111111111111111111111
10000000000000000000000000000000001
10000000000000000000000000000000001
10000000000000000000000000000000001
10000000000000000000000000000000001
1000000000000011P110000000000000001
10000000000000000000000000000000001
10000000000000000000000000000000001
1000000000002000000000000000000001
1000000000000000N000000000000000001
11111111111111121111111111111111111