NO ./assets/textures/mur_1.xpm
SO ./assets/textures/mur_2.xpm
WE ./assets/textures/mur_3.xpm
EA ./assets/textures/mur_4.xpm

F 50,50,50
C 101,67,33

111111111111111
100000000000001
100000001000001
100000010000001
100000000000001
100000000000001
1000000W0000001
100000000000001
100000000000001
100000000000001
100000000000001
111111111111111
