NO ./assets/textures/mur_1_128.xpm
SO ./assets/textures/mur_2_128.xpm
WE ./assets/textures/mur_3_128.xpm
EA ./assets/textures/mur_4_128.xpm

F 50,50,50
C 100,85,70

111111111111111
100000000000001
100000001000001
100000010000001
100000000000001
100000000000001
100000N00000001
100000000000001
100000000000001
100000000000001
100000000000001
111111111111111
