NO ./assets/textures/mur_1_128.xpm
SO ./assets/textures/mur_2_128.xpm
WE ./assets/textures/mur_3_128.xpm
EA ./assets/textures/mur_4_128.xpm

F 50,50,50
C 100,85,70

111111111111111
100000000000001
100000001000S01
11111P110000001
100000000000001
100000000000001
100000000000001
100000000000001
100000000000001
100000000000001
11111111P1111111
11111112021111111
12000000000000021
12000000000000021
12000000000000021
12000000000000021
12222222222222221
11111111111111111