NO ./assets/textures/mur_1_128.xpm
SO ./assets/textures/mur_2_128.xpm
WE ./assets/textures/mur_3_128.xpm
EA ./assets/textures/mur_4_128.xpm

F 50,50,50
C 101,67,33

111111111111111
100000P000000W1
10000011111111111111111111
10000010000000000000010001
100000100000000000000P0001
100000P0000000000000010001
11101111111011111111110001
110000110000001      10001
100000010000001      10001
100000010000001      10001
1000000P000000111111111P11111111111
10000001000000100000000000000000001
100000010000001000000000000000000011111
110000110000001001110000000000110010001
111111111111111001000000000000010010001
              1000000000000000000010001
              1000000000000000000010001
              1000000000000000000000001
              1000000000000000000010001
              1000000000000000000010001
              1001000000000000010010001
              1001100000000000110010001
              1000000000000000000010001
              1000000000000000000010001
              1111111111111111111110001
                                  11P11
                               11110001111
                               10000000001
   1111111111111               10000000001
   1000000000001               10000000001
   1000000000001               10000000001
   1000000000001               10000000001
   1000000000001               10000000001
   1000000000001               10000000001
   10011111111111111111111     11111P11111
   10000000000000000000001       100001
   11110000000000000000001       100001
      10000000000000000001       100001
  1111100000000000011101111111111100001
  1000000000000000010000000000000000001
  1000100000000000010000000000000000001
  1000100000000000010000000000000000001
  1000111111P11111110000000000000000001
  1000000010001    111P1111111111111111
  1000000010001    100000000001
  1000000010001    100000000001
  1111011110001    100000000001
    10001 10001    100000000001
    10001111111    100000000001
    10000000001    100000000001
    11111100001    111111011111
         1100011       10001
          10001        10001
           10001       10001
            10001      11111
             10001 
              10001 
              110001
               110001111111111111111111111111111111111111
                10101000000000000000000000000000000000001
                101P1000000000000000000000000000000000001
                11100000000000000000000000000000000000001
                10000000000000000000000000000000000000001
                10000000000000000000000000000000000000001
                10000000000000000000000000000000000000001
                10000000000000000000000000000000000000001
                10000000000000000000000000000000000000001
                10000000000000000000000000000000000000001
                10000000000000000000000000000000000000001
                10000000000000000000000000000000000000001
                10000000000000000000000000000000000000001
                10000000000000000000000000000000000000001
                10000000000000000000000000000000000000001
                10000000000000000000000000000000000000001
                10000000000000000000000000000000000000001
                10000000000000000000000000000000000000001
                10000000000000000000000000000000000000001
                10000000000000000000000000000000000000001
                10000000000000000000000000000000000000001
                10000000000000000000000000000000000000001
                10000000000000000000000000000000000000001
                10000000000000000000000000000000000000001
                10000000000000000000000000000000000000001
                10000000000000000000000000000000000000001
                10000000000000000000000000000000000000001
                10000000000000000000000000000000000000001
                10000000000000000000000000000000000000001
                10000000000000000000000000000000000000001
                10000000000000000000000000000000000000001
                10000000000000000000000000000000000000001
                10000000000000000000000000000000000000001
                10000000000000000000000000000000000000001
                10000000000000000000000000000000000000001
                10000000000000000000000000000000000000001
                10000000000000000000000000000000000000001
                10000000000000000000000000000000000000001
                10000000000000000000000000000000000000001
                10000000000000000000000000000000000000001
                10000000000000000000000000000000000000001
                10000000000000000000000000000000000000001
                10000000000000000000000000000000000000001
                10000000000000000000000000000000000000001
                10000000000000000000000000000000000000001
                1000000000000000000000000000000000000000122222222
                1000000000000000000000000000000000000000P00000002
                1111111111111111111111111111111111111111200000002
                                                        200000002
                                                        200000002
                                                        200000002
                                                        200000002
                                                        222222222