NO ./assets/textures/kjdhfgkjsfg?.xpm
SO ./assets/textures/sdfgsdfg.xpm
EA ./assets/textures/dkfhafkdalksdf/mur_4_128.xpm
WE fghjdskfdjskfkhjdfksaldfdjhskfhjfdksfhgdkshj

F 50,50,50
C 25,25,25

11111111
10000001
10000001
1000N001
11111111
